111111111111
100P000000C1

1000000000E1
111111111111