1111111111111111111111111111111111
1CE00X000000000C00000C000000000001
1110010100100000101001000000010101
1010010010101010001001000000010101
1P0000000C00C00000X0000000000000C1
1111111111111111111111111111111111