111111111
100PC00E1
100000001
111111111